111101
111101
110001
100001
100011
111011
